9
10
..###.....
..#C#.....
..########
###c.d.D##
#B.b@#####
####a#....
...#.#....
...#A#....
...###....
