5
10
###!####..
#.@.....A#
#....#...#
#B.....A.#
##########