5
          10
          ########..
          #.@..a..A#
          #.b..#...#
          #B.....A.#
          ##########